BRIGHTNESS	B R AY T N AH S
CALENDAR	K AE L AH N D ER
CHANGE	CH EY N JH
DECREASE	D IH K R IY S
DECREASE(2)	D IY K R IY S
DISPLAY	D IH S P L EY
FIFTY	F IH F T IY
LIGHT	L AY T
LIGHTS	L AY T S
NEWS	N UW Z
NEWS(2)	N Y UW Z
OFF	AO F
OKEY	OW K IY
ON	AA N
ON(2)	AO N
PIE	P AY
PUT	P UH T
SLEEP	S L IY P
THE	DH AH
THE(2)	DH IY
TIME	T AY M
TO	T UW
TO(2)	T IH
TO(3)	T AH
TURN	T ER N
UP	AH P